11111111111111
10000P00000001
10000000000E01
10000000000001
11111111111111