11111111111111111
10000000000000P01
10000000000000001
10000CCCC00000001
10000000000000001
11111111111111111