11111111111111111111111111
10P1000000C000000000C00C01
10000111111000011111000001
1000110E00000101C001111001
10C011000000110000010C0001
10001100CC0011000001C00001
11111111111111111111111111