11111111111111
1000000C000001
10000000000001
1000000E000001
11111111111111