11111111111111
10000C00000001
000000000P0001
1000E000000001
11111111111111